24
01
02 20
08 08 08 08 08 08 08 08 08 08
08 08 08 08 08 08 08 08 08 08
08 08 08 08 08 08 08 08 08 08
08 08 08 08 08 08 08 08 08 08
08 08 08 08 08 08 08 08 08 08
12 08 08 08 08 08 08 08 08 12
12 12 08 08 08 08 08 08 12 12
12 12 12 08 08 08 08 12 12 12
12 12 12 12 08 08 12 12 12 12