24
01
02 12
XX XX XX XX XX XX XX XX XX
XX XX XX XX XX XX XX XX XX
XX XX XX XX XX XX XX XX XX
XX XX XX XX XX XX XX XX XX
XX XX XX 10 10 10 XX XX XX
XX XX XX XX 10 XX XX XX XX
12 XX XX XX XX XX XX XX 12
12 12 XX XX XX XX XX 12 12
12 12 12 XX XX XX 12 12 12