24
02 12
10 10 10 10 10 10 10 10 10
10 10 10 10 10 10 10 10 10
10 10 10 10 10 10 10 10 10
10 10 10 10 10 10 10 10 10
10 10 10 69 69 69 10 10 10
10 10 10 10 69 10 10 10 10
96 10 10 10 10 10 10 10 96
96 96 10 10 10 10 10 96 96
96 96 96 10 10 10 96 96 96