24
01
02 12
08 08 08 08 08 08 08 08 08
08 08 08 08 08 08 08 08 08
08 08 08 08 08 08 08 08 08
08 08 08 08 08 08 08 08 08
08 08 08 10 10 10 08 08 08
08 08 08 08 10 08 08 08 08
12 08 08 08 08 08 08 08 12
12 12 08 08 08 08 08 12 12
12 12 12 08 08 08 12 12 12